# # # # # # # # # # # # # # # # # # # #
# . . . . . # . . . . . . . # * * * . #
# # # # # . # . # # # # # . # . . . . #
# . . . . . . . . . . . . . # . # # # #
# . # # # # # # # # # # # # # . . . . #
# . . . . . . . . . . . . . . . # # . #
# # # # # . # # # # # ~ ~ ~ # # # . . #
# . . . . . # . . . . ~ . ~ . . . . . #
# . # # # # # . # # # ~ . ~ # # # # . #
# . . . . . . . . . . ~ . ~ . . . . . #
# . # # # # # # # # # ~ . ~ # # # # . #
# . . * * . . . . . . ~ . ~ . . . . . #
# # # # # . # # # # # ~ . ~ # # # # . #
# . . . . . . . . . . ~ . ~ . . . . . #
# . # # # # # # # # # # . # # # # # . #
# . . . . . . . . . . . . . . . . . . #
# # # # # # # # # # # # # # # # # # # #