# # # # # # # # #
# . # * * * # . #
# . # # # # # . #
# . . . # . . . #
# # # # # # # . #
# . . . . . # . #
# . # # # # # . #
# # # # # # # # #