# # # # # # # # # # # # # # # #
# . . . ~ ~ . . . * * . . . . #
# # # . # # # . # # # . # # . #
# . . . . . . . . . . . . . . #
# . # # # ~ ~ # # # # # # # . #
# . . . . ~ . . . . . . . # . #
# # # # . ~ . # # # # # . # . #
# * * . . ~ . . . . . # . . . #
# * # # # # # # # # . # . # # #
# * . . . . . ~ ~ . . # . . . #
# * # # # # . ~ . # # # # # . #
# * . . . . . ~ . . . . . . . #
# * # # # # # ~ # # # # # # . #
# . . . . . . . . . . . . . . #
# # # # # # # # # # # # # # # #