# # # # # # # # #
# . . # * * # . #
# # . # # # . . #
# . . . ~ ~ ~ . #
# . # # # # # . #
# . . * ~ * . . #
# # . # # # . # #
# # # # # # # # #