# # # # # # # # #
# . . . . . . . #
# . # # # . # . #
# . # * * . # . #
# . . . . . # . #
# . # # # . . . #
# . . . . . # . #
# # # # # # # # #