# # # # # # # # #
# . # . . . . . #
# . # . # # # . #
# . # . . . # . #
# . # # # . # * #
# . . . . . # . #
# # # # # # # . #
# # # # # # # # #