# # # # # # # # # 
# . # . * * # . #
# . # . # # # . # 
# . # . ~ ~ ~ ~ #
# . # . . # . . # 
# . . . . # . # # 
# . # # . # . # #
# # # # # # # # # 
