# # # # # # # # # # # # # # # # #
# . . . # . . # . . . . . . . . #
# # # # # . . # . . . . . . . . #
# . * * * * . # . . . . # . . . #
# * . * . . # # # # # # . . . . #
# * . * # # . # ~ . . . . . . . #
# * . * # . . # ~ . . * . . . . #
# * . * # . . # ~ . . * . . . . #
# * . * # . . # ~ . . * . . . . #
# . . * # . . # ~ . . * . . . . #
# . . * # . . # ~ . . . . . . . #
# . . . . . . # ~ . . . . . . . #
# . . . . . . . ~ . . . . . . . #
# # # # # # # # # # # # # # # # #
